000 000 133 000 000 000 000 133 000 000
000 133 133 133 000 000 133 133 133 000
000 133 133 133 000 000 133 133 133 000
133 133 133 133 133 133 133 133 133 133
133 133 133 133 133 133 133 133 133 133
133 133 133 133 133 133 133 133 133 133
000 133 133 133 133 133 133 133 133 000
000 133 133 133 133 133 133 133 133 000
000 000 133 133 133 133 133 133 000 000
000 000 133 133 133 133 133 133 000 000
000 000 133 133 133 133 133 133 000 000
000 000 000 133 133 133 133 000 000 000
000 000 000 133 133 133 133 000 000 000
000 000 000 000 133 133 000 000 000 000
000 000 000 000 133 133 000 000 000 000
000 000 000 000 133 133 000 000 000 000
000 000 000 000 133 133 000 000 000 000
000 000 000 000 133 133 000 000 000 000
000 000 000 000 133 133 000 000 000 000
000 000 000 000 133 133 000 000 000 000

