000 000 000 000 000 000 000 000 000 000
000 000 000 000 000 000 000 000 000 000
000 000 000 000 000 000 000 000 000 000
000 000 000 000 000 000 000 000 000 000
000 000 000 000 000 000 000 000 000 000
000 000 000 000 000 000 000 000 000 000
000 000 000 000 000 000 000 000 000 000
121 000 000 000 000 000 000 000 000 000
121 101 000 000 000 000 000 000 000 000
121 101 121 000 000 000 000 000 000 000
121 101 121 101 000 000 000 000 000 000
121 101 121 101 121 000 000 000 000 000
121 101 121 101 121 101 000 000 000 000
121 101 121 101 121 101 121 000 000 000
113 113 113 113 113 113 113 113 000 000
000 000 000 000 000 000 000 000 000 000
000 000 000 000 000 000 000 000 000 000
000 000 000 000 000 000 000 000 000 000
000 000 000 000 000 000 000 000 000 000
000 000 000 000 000 000 000 000 000 000

